1111111111111111111111111111111111111111111111111111111111111111111111111111111111111111111111111111
0000000000111111111111111111111111111111111111111000000000001111111111111111111111111111111111111111
1111111110000000000111111111111111111111111111111011111111101111111111111111111111111111111111111111
1111111110111111110000011111111111111111111111111011111111101111111111111111111111111111111111111111
1111111110001111111111000000000000111111111111111011111111111111111111111111111111111111111111111111
1111111110111111111111111111111110000000000001111011111111111111111111111111111111111111000000001111
1111111110111111111111111111111110111111111100000000000111111111111111111111111111111111011111101111
1111111110000000001111111111111110000000111111111111110000001111111111111111111111111111011111101111
1111111110111111111111111111111110111110111111111111111111101111111111111111111111111111011111100001
1111111110111111111111111111111110111110111111111111111111100000000011111111111111111111011111101111
1111111110111111111111111111111110111110111110000000000111111111111011111111111111111111011111101111
1000000000111111111101111111111110111111111110111111110111111111111011111111111111111111011111101111
1111111110111111111101111111111110111111111110100000000111111111111011111111111111111111011111101111
1111111110111111111101111111111110111111111110111111111111111111111011111111111111111111011111101111
1111111110111111111101111111111110111111111110000000000000000000000000000000001111111111011111101111
1111111110000000011100000000000000111111111111111111111111111111111011111111100000000000011111101111
1111111111111111111111111111111110111111111111111111111111111111111011111111101111111111111111101111
1111111111111111111111111111111110111111111111111111111111111111111011111111101111111111111111101111
1111111111111111111111111111111110111111111111111111111111111111111011111111101111111111111111101111
1111111111111111111111111111111110111111111111100000000000000000000011111111101111111111111011101111
1111111111111111111111111111111110111111111111111111111111111111111011111111101111111111111011101111
1111111111111111111111111111111110111111111111111111111111111111111011111111101111111111111011101111
1111111111111111111111111111111110111111111111111111111111111111111011111111101111111111111011101111
1111111111111100000000000000000000110000000000000011111111111111111011111111101111111111111011101111
1111111111111101111111111111111110110111111111111011111111111111111011111111101111111111111011101111
1111111111111101111111111111111110110111111111101011111111111111111011111111100000000111111011101111
1111111111111101111111111111111110110000000000001011111111111111111011111111111111110111111000001111
1111111111111101111111111111111110111111111111111011111111111111111011111111111111110111111111111111
1100000000000000001111111111111110000000000000000011111111111111111000000000000000110000000000000001
1131111111111111111111111111111111111111111111111111111111111111111111111111111111111111111111111111

